1111111111111
101000C0000F1
1110011111101
10PC11E000001
1111111111111