1111111111111111111111111111111111111111111111111111111111111111111111111111111111111111111111111111111111111111111111111
1000000000000000000000000000000000000000000000000000000000000000000000000000000000000000000000000000000000000000000000001
1000000000000000000000000000000000000000000000000000000000000000000000000000000000000000000000000000000000000000000000001
1000000000000000000000000000000000000000000000000000000000000000000000000000000000000000000000000000000000000000000000001
1000000000000000000000000000000000000000000000000000000000000000000000000000000000000000000000000000000000000000000000001
1000000000000000000000000000000000000000000000000000000000000000000000000000000000000000000000000000000000000000000000001
10000000000000000000000000000C00CCC000C0000000000000000000000000000000000000000000000000000000000000000000000000000000001
10000000000000000000000000000C00001000C0000000000000000000000000000000000000000000000000000000000000000000000000000000001
10000000000000000000000010000C0001P100C0000000000000000000000000000000000000000000000000000000000000000000000000000000001
10000000000000000000000010000C0000000000000000000000000000000000000000000000000000000000000000000000000000000000000000001
10000000000000000000000010000000CCCC0000000000000000000000000000000000000000000000000000000000000000000000000000000000001
1000000000000000000000001000000000000000000000000000000000000000000000000000000000000000000000000000000000000000000000001
1000000000000000000000001000000000000000000111111111111111111111111111111110000000000000000000000000000000000000000000001
1000000000000000000001111111000000000000000000000000000000000000000000000000000000000000000000000000000000000000000000001
1000000000000000000000000000000000000000000000000000000000000000000000000000000000000000000000000000000000000000000000001
1000000000000000000000000000000000000000000000000000000000000000000000000000000000000000000000000000000000000000000000001
1000000000000000000000000001000000010100000000000000000000010000000000000000000000000000000000000000000000000000000000001
1000000000000000000000000000000001100011000000000000000000010000000000000000000000000000000000000000000000000000000000001
10000000000000000000000000111000000000000000000000000000000100000000000000000000000CCCCCCCCCCCCCCCCCCC0000000000000000001
1000000000000000000000000000000001100011000000000000000000010000000000000000000000000000000000000000000000000000000000001
100000000000000000000000000000000001010000000000000CCCCCCCCCCCCCCCCCCCCCC0000000000000000000000000000000000000000000000C1
1000000000000000000000000000000000000000000000000000000000010000000000000000000000000000000000000000000000000000000000001
1000000000000000000000101000000000000000000000000000000000010000000000000000000000000000000000000000000000000000000000001
1000000000000000000001000100000000000000000000000000000000010000000000000000000000000000000000000000000000000000000000001
1000000000000000000001010100000000000000000000000000000000010000000000000000000000000000000000000000000000000000000000001
1000000000000000000001000100000000000000000000000000000000010000000000000000000000000000000000000000000000000000000000001
1000000000000000000000111000000000000000000000000000000000000000000000000000000000000000000000000000000000000000000000001
1000000000000000000CCCCCCCCCCCCCCCCCCCCCC00000001111111111111111111111111111100000000000000000000000000000000000000000001
1000000000000000000CCCCCCCCCCCCCCCCCCCCCC00000000000000000000000000000000000000000000000000000000000000000000000000000001
1000000000000000000CCCCCCCCCCCCCCCCCCCCCC00000000000000000000000CCCCCCCCCCCCCCCCCCCCCCCCCCCCCCCCCCCCCCCCCCCCCCCC000000001
1000000000000000000CCCCCCCCCCCCCCCCCCCCCC00000000000000000000000CCCCCCCCCCCCCCCCCCCCCCCCCCCCCCCCCCCCCCCCCCCCCCCC000000001
1000000000000000000CCCCCCCCCCCCCCCCCCCCCC00000000000000000000000CCCCCCCCCCCCCCCCCCCCCCCCCCCCCCCCCCCCCCCCCCCCCCCC000000001
1000000000000000000CCCCCCCCCCCCCCCCCCCCCC00000000000000000000000CCCCCCCCCCCCCCCCCCCCCCCCCCCCCCCCCCCCCCCCCCCCCCCC000000001
1000000000000000000CCCCCCCCCCCCCCCCCCCCCC00000000000000000000000CCCCCCCCCCCCCCCCCCCCCCCCCCCCCCCCCCCCCCCCCCCCCCCC000000001
1000000000000000000CCCCCCCCCCCCCCCCCCCCCC00000000000000000000000CCCCCCCCCCCCCCCCCCCCCCCCCCCCCCCCCCCCCCCCCCCCCCCC000000001
100000000000000000000000000000000000000000000000000000000000000000000000000000000000000000000000E000000000000000000000001
1000000000000000000000000000000000000000000000000000000000000000000000000000000000000000000000000000000000000000000000001
1000000000000000000000000000000000000000000000000000000000000000000000000000000000000000000000000000000000000000000000001
1000000000000000000000000000000000000000000000000000000000000000000000000000000000000000000000000000000000000000000000001
1111111111111111111111111111111111111111111111111111111111111111111111111111111111111111111111111111111111111111111111111