111111111111111111111111111111111111111111111111111111111111111111111111111111111111111111111111111111111111111
100000000000000000000000000000000000000000000000000000000000000000000000000000000000000000000000000000000000001
100000000000000000000000000000000000000000000000000001000000000000000000000000000000000000000000000000000000001
100000000000000000000000000000000000000000000000000000000000000000000000000001000000000000000000000000000000001
100010000000000001111111111111111111111111110000001100000000000000000110110000000000000000000000000000000000001
10000000000000000111111111111111111111111111000000000000000000000000110P010000000000110000000000000000000000001
100000000000000001111111100011111C00011111111000000000000000000000001E00100000000000000000000000000000000000001
100000100000000001111100000011111110000000000000000000000000000000000100110000000000000000000000000000000000001
100000000000000001111111100011111111111111101001000000000000000000000000000000000000000000000000000000000000001
10000000000000000111111110C011111111111111100000000000000000000001000000000000000000000000000000000000000000001
100000000000000001111111100111111111111110000000000000000000000000000000000000000000000000000100000000000000001
100000000000000001111111100111111111111110000000000000000000000000000000000000000000000000000000000000000000001
100000000000000000111111110011111111111110000000000000000000000000000001000000000000000000000000000000000000001
100000000000000000110000000001111111111110000000000000000000000000000000000000000000000000000000000000000000001
100000000000000000111011111100000111111110000000000000000000000000000000000001111111111111000000000000000000001
100000000000000000100011111111100111111110000000000000000000000000000000011111111111111111111100000000000000001
100000000100000000001111111111100111111111100000000000000000000000000000011111111111111111111100000000000000001
100000000000000000111111111111110C01111111100000000011000000000000000000011111111111111111111100000000000000001
100000000000000001111111111111111111111111100000000000000000000000000000001111111111111000111000000000000000001
100000000000000001111111111111111111111111100000000000000000000000000000001111111111100010111000000000000000001
1000000000000000001110000000000000011111111000000000000000001100000000000011111111C0001100000000000000000000001
100000000000000000000000000000000000000000000000000000000000000000000000011111111111111111111100000000000000001
100000000000000000000010000000000000000000000000000000000000000000000000011111111111111111111100000100000000001
100000000000000000000000000000000000100000000000000000000000000000000000111111111111111111111100000000000000001
100000000000010000000000000100000000000000000000000000000000000000000000111111111111111111100000000000000000001
100000000000000000000000000000000000000000000000000000001000000000000000011111111111111111111100000000000000001
100000000000000011111000000000111000000000000000000000000000000000000000011111111111111111111100000000000000001
100000100000000111111111111111111111000000100000000000000000000000000000011100000011111111111100000000000000001
100000000000000011111111111111111111000000000000000000000000000000000000000000000000000000000000000000000000001
100000000000000011111111111111111000000000000000000000000000000000000000000000000000000000000000000000010000001
100000000000000011111111111111111000000000000000000000000010000000000000000000000000011000000000000000000000001
10000000000000000111100C111111111000000000000000000000000000000000000000000000000000000000000000000000000000001
100000000000000100000000111111111000000000000000000000000000000000000000000000000000000000000000000000000000001
100000000000000110000011111111111111000000000000000000000000000000000000000000000000000000000000000000000000001
100000000000000111111001111111111111000000000000000000000000000111100100000000000001100000000001000000000000001
100000000000000111111100111111111110000000000100000000000001111111111000000000000000000000000000000000000000001
100000000000000111111110011111111110000000000000000000000001111110000000000000100000000000000000000000000000001
100000010000000111111111011111111110000000000000000000000001110000111100000000000000000000000000000000000000001
1000000000000001111111110011111111100000000000000000000000011000110C1100000000000000000000000000000000000000001
100000000000000111111111101111111110000000000000000000000001110111011100000000001100000000000000001000000000001
100000000000000111111111000011111110000000000000000000000001110111011100000000000000000000000000000000000000001
10000000000000001111111100C011111110000000000000000000000000000000011100000000000000000000000000000000000000001
100000000000000011111111000011111110000000000001000000000001111111111100000000110000000000000000000000000000001
100000000000000011111111111111111111000000000000000000000001111111111100000000000000000000000000010000000000001
100001000000000011111111111111111001000000000000000000000000000000000000000000000000000000000000000000000000001
10000000000000001111111111111111C000000000000000000000000000000000000000000000000000000000000000001000000000001
100000000000000111111111111111111111000000000000000000000000000000000000110000000000000000000000000000000000001
100000000000000111111000000001111111000000000000000011000000000000000000000000000000000000000000000000000000001
100000000000000000000000000000000000000000100000000000000000000000000000000000000000100000000000000000000000001
100000000000000100000000000000000000000000000000000000000000000000000000000000000000000000000000000000000000001
100000000000000000000000000000000000000000000000000000000000000110000000000000100000000000000000000000000000001
100000000000000000000000000000000000000000000000000000000000000000000000000000000000000000000000000000000000001
111111111111111111111111111111111111111111111111111111111111111111111111111111111111111111111111111111111111111