111111111111111111111111111111111111111111111111111111111111111111111111111111111111111111111111111111111111111
1P00C000000000000000000C000000000000000000000C0000000000000000000000000000000000000000000C000000000000000000001
100000000000C000000000000000000000C0000000000000000001111111111011111111111111111111111111111111111111111111001
111111111111111111111011111111111111111111111111111101111111111011111111111111111111111111111111111111111111001
111111111111111111111011111111111111111111111111111101111111111000001111111111111111111111111111111111111111001
111111111111111111111011111111111111111111111111111101111111111111100000000111111111111111111111111111111111001
111111111111111111111011111111111111111111111111111101111111111111111000C00111111111111111111111111111111111001
111111111111110000000011111111111100000000000000000001111111111111111000C00111111111111111111111111111111111001
111111111111110111110111111111111101111111111111111111111111111111111000C00111111111111111111111111111111111001
111111111111110111110111000000000001111111111111111111111111111111111000C00111111111111111111100000000000000001
111111111111110111110111011111111101111111111111111111111111111111111000C00111111111111111111101111111111111001
111111111111110111110000011111111101111111111111111111111111111111111000C00111111111111111111101111111111111001
111111111111110111110111111111111101111111111111111111111111111111111000000111111111111111111101111111111111001
111111111111110111111111111111111101111111111111111111111111111111111111101111111111111111111101111111111111001
111110000000000111111111111111111101111111111111111111111111111111111111101111111111111111111101111111111111001
111111111111111111111111111111111100000000000000000000000000000000000000000000000000000000000F01111111111111001
111111111111111111111111111111111101111111111110111111111111101111111111111111111111111111111101111111111111001
111111111111111111111111111111111101111111111110111111111111101111111111111111111111111111111101111111111111001
11111111111111111111111111111111110111111111111011111111111110111111110000000000111111111111110F000000000000001
111111111111111111111111111111111101111111111110111111111111101111111101111111101111111111111101111111111111001
111111111111111111100000000000000001111111111110111111111111101111111101110C11101111111111111101111111111111001
111111111111111111111111111111111101111111111111111111111111101111111100000111101111111111111101111111111111001
111111111111111111111111111111111101111111111111111111111111101111111111111111101111111111111101111111111111001
1111111111111111111111111111111111C1111111111111111111111111100000000000000000001111111111111101111111111111001
1111111111111111C1111111111111111111111111111111111111111111101111111111111011111111111111111101111111111111001
111111111111111101111111111111111111111111111111111111111111101111111111111011111111111111111101111111111111001
111111111111111101111111111111111111111111111111111111111111101111111111111011111111111C11111101111111111111001
111111111111111101111111111111111111111111111111111111111111101111111111111011111111111011111101111111111111001
111111111111111101111111111111111111111111110000000000000000001111111111111111111111111011111101111111111111001
111111111111111101111111111111111111111111111111111111011111111111111111111111111111111011111101111111111111001
111111111111111101111111111111111111111111111111111111011111111C11111111111111111111111011111101111111111111001
111111111111111101111111111111111111111111111111111111000000000011111111111111111111111011111101111111111111001
111111111111111101111111111111111111111111111111111111011111111011111110000000000000000000000001111111111111001
1111111C0000000000000000000000000000000000000000000000011111111011111111111111111111111111111111111111111111001
111111111111111111111111111101111111111111111111111111011111111111111111111101111111111111111111111111111111001
111111111111111111111111111101111111111111111111111111011111111111111111111101111111111111111111111111111111001
111111111111111111111111111101111111111111111111111111011111111111111111111101111111111111111111111111111111001
111111111111111111111111111101111111111111111111111111000000000000000000000001111111111111111111111111111111001
1111111111111111111111111111011111111111111111111111110111111111111111F1111111111111111111111111111111111111001
111111111111111C00000000000001111111111111111111111111011111111111111101111111111111111111111111111111111111001
111111111111111111011111111101111111111111111111111111011111111C000000000000C1111111111111111111111111111111001
111111111111111111011111111111111111111110000000000000011111111111111101111111111111111111111111111111111111FF1
111111111111111111011111111111111111111111111111111111011111111111111101111111111111111111111111111111111111001
111111111111111111011111111111111111111111111111111111000000000000000001111111111111111111111111111111111111001
111111111111111111011111111111111111111111111111111111111111111111111101111111111111111111111111111111111111001
1111111111111111110111111111111111111111111111111111111111111111111111000000000000000000000000000C1111111111001
111111111111111111011111111111111111111111111111111111111111111111111101111111111111111111110111111111111111001
1111111111111111110000000000000000000C1111111111111111111111111111111101111111111111111111110111111111111111001
111111111111111111011111111111111011111111111111111111111111111111111101111111111111111111110111111111111111001
1C0000000000000000011111111111111011111111111111111111111111111111111101111111111111111111110111111111111111001
111111111111111111111111111111111011111111111111111111111111111111111101111111111111111111111111111111111111001
111111111111111111111111111111111011111111111111111111111111111111111101111111111111111111111111111111111111001
111111111111111111111111111111111011111111111111111111111111111111111101111111111111111111111111111111111111001
1111111111111111111111111111111110111111111111111111111111111111111111F1111111111111111111111111111111100000001
10000000000000000000000000000F0000000000000000000000000000000000000000000000000000000000000000000000000000000E1
111111111111111111111111111111111111111111111111111111111111111111111111111111111111111111111111111111111111111