11111111111111111111111111111111111111111111111111111111
1000011111111111111111C11111111111111111C0111110000C1111
1E000111110000000000000111111111111111111011111011111111
10000011110111111C1111011111111111111111101111C011111111
11100011110111111111110111111111111111111011111011111111
11110000000C11111111110111111111111111111011111011111111
11110111111111111111110111111111111111111000000000C11111
11110111111111111111110C11111111111111111011111111111111
11110111111110000000000111111111111111111011001000010001
1111011111111011111111111111111111111111101101C0110C1001
111101111111101111111111111111111111111110000001CC000001
1111011111111011111111111C1111111111111110000001CC000001
1111011111111000000000000011111111111111101101C0110C1001
11110111111111111111111110111111111111111011001000010001
11110111111111111111111110111111111111111011000000000001
11110111111111111111110000000111111111111011111111111111
1111000000000000000000000P000000000000000011111111111111
111101111111111111111100000001111110111110C1111C11111111
11110111111111111111111110111111111011111111111011111111
11110111111111111111111111111111111011111111111011111111
11110000000111111111111C11111111111011111111111011111111
11110111110111111111000000000000000011111111111011111111
1111011111C1111111110111111111C1111011111111111011111111
11110111100011111111011111111111111000000000000011111111
11110111000001111111011111111111111011111111111C11111111
1111011C00C00C111111011111111111111000001111111111111111
11110111000001111111011111111111111111101111111111111111
11110111100011111111011111111111111000001111111111111111
1111011111C111111111C1111111111111C011111111111111111111
11110111111111111111111111111111111000000000111111111111
1111C11111111111111111111111111111111111111C111111111111
11111111111111111111111111111111111111111111111111111111