1111111111111111111111111111111111111111111111111111111111111111111111111111111111111111111111111111111111111111111111111
1000000000000000000000000000000000000000000000000000000000000000000000000000000000000000000000000000000000000000000000001
1000000000000000000000000000000000000000000000000000000000000000000000000000000000000000000000000000000000000000000000001
1000000000000000000000000000000000000000000000000000000000000000000000000000000000000000000000000000000000000000000000001
1000000000000000000000000000000000000000000000000000000000000000000000000000000000000000000000000000000000000000000000001
1000000000000000000000000000000000000000000000000000000000000000000000000000000000000000000000000000000000000000000000001
1000000000000000000000000000000000000000000000000000000000000000000000000000000000000000000000000000000000000000000000001
1000000000000000000000000000000000100000000000000000000000000000000000000000000000000000000000000000000000000000000000001
1000000000000000000000001000000001P10000000000000000000000000000000000000000000000000000000000000000000000000000000000001
1000000000000000000000001000000000000000000000000000000000000000000000000000000000000000000000000000000000000000000000001
100000000000000000000000100000000000000000000000000000000000000000000000000000000000000000000000C000000000000000000000001
1000000000000000000000001000000000000000000000000000000000000000000000000000000000000000000000000000000000000000000000001
1000000000000000000000001000000000000000000111111111111111111111111111111110000000000000000000000000000000000000000000001
1000000000000000000001111111000000000000000000000000000000000000000000000000000000000000000000000000000000000000000000001
1000000000000000000000000000000000000000000000000000000000000000000000000000000000000000000000000000000000000000000000001
1000000000000000000000000000000000000000000000000000000000000000000000000000000000000000000000000000000000000000000000001
1000000000000000000000000001000000010100000000000000000000010000000000000000000000000000000000000000000000000000000000001
1000000000000000000000000000000001100011000000000000000000010000000000000000000000000000000000000000000000000000000000001
1000000000000000000000000011100000000000000000000000000C00010000000000000000000000000000000000000000000000000000000000001
1000000000000000000000000000000001100011000000000000000000010000000000000000000000000000000000000000000000000000000000001
100000000000000000000000000000000C010100000000000000000000010000000000000000000000000000000000000000000000000000000000001
1000000000000000000000000000000000000000000000000000000000010000000000000000000000000000000000000000000000000000000000001
1000000000000000000000101000000000000000000000000000000000010000000000000000000000000000000000000000000000000000000000001
1000000000000000000001000100000000000000000000000000000000010000000000000000000000000000000000000000C00000000000000000001
1000000000000000000001010100000000000000000000000000000000010000000000000000000000000000000000000000000000000000000000001
1000000000000000000001000100000000000000000000000000000000010000000000000000000000000000000000000000000000000000000000001
1000000000000000000000111000000000000000000000000000000000000000000000000000000000000000000000000000000000000000000000001
1000000000000000000000000000000000000000000000001111111111111111111111111111100000000000000000000000000000000000000000001
1000000000000000000000000000000000000000000000000000000000000000000000000000000000000000000000000000000000000000000000001
1000000000000000000000000000000000000000000000000000000000000000000000000000000000000000000000000000000000000000000000001
1000000000000000000000000000000000000000000000000000000000000000000000000000000000000000000000000000000000000000000000001
1000000000000000000000000000000000000000000000000000000000000000000000000000000000000000000000000000000000000000000000001
1000000000000000000000000000000000000000000000000000000000000000000000000000000000000000000000000000000000000000000000001
1000000000000000000000000000000000000000000000000000000000000000000000000000000000000000000000000000000000000000000000001
10000000000000000000C0000000000000000000000000000000000000000000000000000000000000000000000000000000000000000000000000001
100000000000000000000000000000000000000000000000000000000000000000000000000000000000000000000000E000000000000000000000001
1000000000000000000000000000000000000000000000000000000000000000000000000000000000000000000000000000000000000000000000001
1000000000000000000000000000000000000000000000000000000000000000000000000000000000000000000000000000000000000000000000001
1000000000000000000000000000000000000000000000000000000000000000000000000000000000000000000000000000000000000000000000001
1111111111111111111111111111111111111111111111111111111111111111111111111111111111111111111111111111111111111111111111111