1111111111111
100000C0000F1
1P00011111001
100C11E000C01
1111111111111