1111111111111
1C0000C000001
1110011111101
10PC11E000001
1111111111111