1111111111111
100C0000000F1
1P00011111001
100011E0000C1
1111111111111